R 400 300
NO ./krest.xpm
SO ./krest.xpm
WE ./krest.xpm
EA ./krest.xpm
S ./krest.xpm
F 34,139,34
C 0,0,255
        1111111111111111111111111
        1000000000110000000000001
        1011000001110000002000001
        1000000000000000000000001
111111111011000001110000000000001
100000000011000001110111110111111
11110111111111011100000010001
11000000110101011100000000001
10002000000000001100000010001
10000000000000001101N10010001
1100000111010101111101101000111
11110111 1110101 100000010001
11111111 1111111 111111111111