R 10000 10000
NO ./bab3.xpm
SO ./baba2.xpm
WE ./baba3.xpm
EA ./baba.xpm
S ./sprite.xpm
F 34,139,34
C 0,0,255
111111111111111
100000000000011
100000000000011
1000000N0000011
100000000000011
100000000000011
100120010001001
111111111111111