R 1920 1080
NO ./bab3.xpm
SO ./baba2.xpm
WE ./baba.xpm
EA ./baba3.xpm
S ./sprite.xpm
F 34,139,34
C 0,0,255


111111111111111
100000011000001
100110000011001
1000020N0020001
100000110000001
100110000011001
111111111111111