R 1920 1080
NO ./bab3.xpm
SO ./baba2.xpm
WE ./baba3.xpm
EA ./baba3.xpm
S ./sprite.xpm
F 34,139,34
C 0,0,255

111111111111111
100000000020001
100020000011001
10000000N000001
101000110002001
100110000011001
111111111111111