R 10000 10000
NO ./txtr1.xpm
SO ./txtr2.xpm
WE ./txtr3.xpm
EA ./txtr4.xpm
S ./sprite_totem.XPM
F 0,30,0
C 0,0,25












































































































                             11111111111111    1111111
                             10000000000001    1000021
                             1000200000200111111002001
                             1000000000000000000000001
                             1000111112000000000002001
                             10000000W0000111111111111
                             100000020000001
                             111111000111111
                                  11111